0000000000
0000000000
0000000000
0000000000
0330220333
3002000300
3002000300
3002000333
3002000300
3002000300
3002000300
0330220300
0000000000
0000000000
0000000000
0000000000

"CCF"