0011111100
0110000110
1100000011
1001001001
1001001001
1010000101
1010000101
1100000011
1000000001
1000000001
1001111001
1001001001
1001001001
1001001001
1001001001
1111111111

"囧"