0000000000
0000000000
0004440000
0040004000
0400000400
4000330040
4000330004
4000000022
4000002200
4000020000
4000222222
4000000004
4000000004
4000000004
0400000040
0044444400

"贪吃怪"