0000200000
0000200000
0002000000
0002020000
0002020000
0020002000
0020002000
0022022000
0002220000
0000220000
0002001000
0002001000
0020000100
0020000100
0200000010
0200000010

"洛谷logo"