0000000000
0000000000
0000000000
1110100101
1000100101
1000100101
1000100101
1000100101
1110100111
0010100001
0010100001
0010100001
0010100001
1110100001
0000000000
0000000000

"514"