0000330000
0003333000
0023333300
0223333330
2223113333
2221111333
2211001133
2210000133
2210000133
2211001143
2221111444
2244114444
0444444440
0044444400
0004444000
0000440000
"Chrome"