0000100000
0000110000
0000101000
0001001000
0001001000
0010010000
0010010000
0100111110
1100000011
1000001111
0000000001
0000001111
0000000001
0000001111
0000000011
1111111110

"点赞"
