0022222200
0200000020
2000000002
2000000002
2000000002
0222222220
0010000100
0010000100
0010000101
0010030111
0110000001
0100000001
0100000111
0100000101
0100000100
0011111100

"小喷菇"