0001112000
0011052200
0110500220
1100500022
1005001002
1005011102
1000501002
1000500002
1000050002
1002050002
1022205002
1002005002
1100050022
0110050220
0011502200
0001222000

"太极"