0000000000
0000000000
0000100000
0000100000
0001110000
0001110000
0011211000
0011211000
0112321100
0112321100
1123332110
1122222110
1111111110
0100100100
0001110000
0011111000

"梅花"