0001000000
0011100000
0100010000
0100010000
1000001001
1040401001
1000001011
1000001111
1000000001
1033301001
1000001110
1000001000
1000001000
1000001000
1000001000
1111111000

"鄙视"