0000000000
0000000000
0000000000
1001001010
1001001010
1001001010
1001001010
1001001010
1001001110
1001000010
1001000010
1001000010
1001000010
1001000010
0000000000
0000000000

"114"