0000000000
0000000000
1111000100
0010000100
0100001010
1111001010
1001010001
1001010001
1001001110
1111000000
1001001110
1001001010
1001001010
1111001110
0000000000
0000000000

"百合"