0000000000
0000000000
0000000000
1110000111
0100110010
0101111010
0101001010
0101111010
0101001010
0101001010
0101001010
0101001010
0100000010
0000000000
0000000000
0000000000

"TAT"