0000000000
0001111000
0010000100
0100000010
1004004001
1000000001
1000000001
1003333001
1030000301
1030550301
1030000301
1003333001
1100000011
0110000110
0011111100
0000000000

"猪头"