0000000000
0000000000
0300000030
0330000330
0303003030
0303003030
0303113030
0331001330
0011001100
0110000110
0102002010
1102002011
1000440001
1100000011
0100000010
0011111100

"小鼠"