0033003300
0033003300
0000000000
0000000000
3300000033
3300220033
0002222000
0022112200
0221111220
2211331122
2113333112
2113333112
2211331122
0221111220
0022222200
0000000000

"狗爪"
