0000000000
0000010100
0000111110
0000010100
0000000000
0100011100
1010101010
1010101010
1010101010
1010111110
0100101010
0000101010
0000101010
0000011100
0000000000
0000000000

"喵"