0000010000
0000110000
0001010000
0010010000
0000010000
0000010000
0000010000
0000010000
0000010000
0000010000
0000010000
0000010000
0000010000
0000010000
0011111110
0000000000